5 5
1 0 1 0 1
2 0 2 0 2
1 2 3 2 1
2 0 2 0 0
5 0 1 0 0